"Echo Chamber"	"Perfect Cell's Memorial"
"To The Echo Chamber"	"To Perfect Cell's Memorial"
"To The Glacier Caves Level 2"	"To Tsuru's Memorial"
"Glacial Caves Level 2"	"Tsuru's Memorial"
"ModStrcurseresist"	"Reduces Curse Length by"
"ModStrMinion"	"additional Minion"
"ModStrTrap"	"additional Trap"
"ModStrCorrupt"	"\red;*** Corrupted (Equipment) ***"
"increaseswithkill"	"(Based on Total Kills)"
"maxlvl"	"Maximum Skill Level Increased by"
"Hellfire Torch"	"Hellfire Torch"
"Hidden Treasure 1"	"Raz's Treasure"
"Hidden Treasure 2"	"Retheion's Treasure"
"Hidden Treasure 3"	"Permachill's Treasure "
"Hidden Treasure 4"	"Corr's Treasure "
"Hidden Treasure 5"	"Dondran's Treasure "
"Hidden Treasure 6"	"Hidden Treasure "
"Hidden Treasure 7"	"Metalistas's Treasure "
"Hidden Treasure 8"	"Adam's Treasure "
"Rainbow Facet 1"	"Rainbow Facet "
"Rainbow Facet 2"	"Rainbow Facet "
"Rainbow Facet 3"	"Rainbow Facet "
"Rainbow Facet 4"	"Rainbow Facet "
"Rainbow Facet 5"	"Rainbow Facet "
"Rainbow Facet 6"	"Rainbow Facet "
"Rainbow Facet 7"	"Rainbow Facet "
"Rainbow Facet 8"	"Rainbow Facet "
"Tinker"	"Tinker Points Left"
"11143"	"Merc Only"
"of Decrepification"	"of Decrepification"
"of lowered Resistance"	"of lowered Resistance"
"of Flesh and Bone"	"of Flesh and Bone"
"Warrior's"	"Warrior's"
"Rogue's"	"Rogue's"
"Highlander's"	"Highlander's"
"Mage's"	"Mage's"
"dy21"	"Undye"
"dy1"	"Lightgrey Dye"
"dy2"	"Darkgrey Dye"
"dy3"	"Black Dye"
"dy4"	"Lightblue Dye"
"dy5"	"Darkblue Dye"
"dy6"	"Crystalblue Dye"
"dy7"	"Lightred Dye"
"dy8"	"Darkred Dye"
"dy9"	"Crystalred Dye"
"dy10"	"Lightgreen Dye"
"dy11"	"Darkgreen Dye"
"dy12"	"Crystalgreen Dye"
"dy13"	"Lightyellow Dye"
"dy14"	"Darkyellow Dye"
"dy15"	"Lightgold Dye"
"dy16"	"Darkgold Dye"
"dy17"	"Lightpurple Dye"
"dy18"	"Darkpurple Dye"
"dy19"	"Orange Dye"
"dy20"	"Brightwhite Dye"
"kills"	"Monsters killed"
"Killcounter"	"Killcounter"
"ModStrrep1"	"Replenishes %d Quantity in %d Frames"
"of Splash"	"of Splash"
"Skillname453"	"Splash Damage"
"healkillStr"	"%d%% of Life Replenished on Kill"
"ModStrrep2"	"Replenishes %d Durability  in %d Frames"
"cooldowndesc"	"Castdelay for "
"hydramagdmg"	"Hydra Magic Damage: "
"ocr1"	"\red;Corruption Orb"
"ocr2"	"\red;Corruption Orb"
"ocr_dsc"	"Corrupts an Item, Modifying it Unpredictably"
"ModStre10dnew"	"\red;(do not use)\blue;"
"increaseswithcoldres"	"(Based on Cold Resistance)"
"increaseswithfireres"	"(Based on Fire Resistance)"
"increaseswithltngres"	"(Based on Lightning Resistance)"
"StrTempFacet1"	"4% Increased Fire damage per Rainbow Facet"
"StrTempFacet2"	"4% Increased Cold damage per Rainbow Facet"
"StrTempFacet3"	"4% Increased Lightning damage per Rainbow Facet"
"StrTempFacet4"	"4% Increased Poison damage per Rainbow Facet"
"toa"	"Token of Absolution"
"of the Mumakil"	"of the Mumakil"
"of the Watcher"	"of the Watcher"
"increaseswithfireres"	"(Based on Cold Resistance)"
"increaseswithcoldres"	"(Based on Fire Resistance)"
"increaseswithltngres"	"(Based on Lightning Resistance)"
"Kron's"	"Kron's"
"Ronal's"	"Ronal's"
"Volcazar's"	"Volcazar's"
"Furozun"	"Furozun"
"Shokku"	"Shokku"
"Nensho"	"Nensho"
"of Flames"	"of Flames"
"of Immolation"	"of Immolation"
"of Incineration"	"of Incineration"
"of the Volcano"	"of the Volcano"
"of Shock"	"of Shock"
"of Zapping"	"of Zapping"
"of Electrocution"	"of Electrocution"
"of Storms"	"of Storms"
"of Chilling"	"of Chilling"
"of Freezing"	"of Freezing"
"of Frost"	"of Frost"
"of Blizzards"	"of Blizzards"
"of Blight"	"of Blight"
"of Venom"	"of Venom"
"of Pestilence"	"of Pestilence"
"of Anthrax"	"of Anthrax"
"ModStrch"	"(Synergy Bonus)"
"ModStrNecFire"	"Fire Golem Holy Fire Aura Damage"
"ModStrNecSkeli"	"Get 1 Skeleton per 5 Level in Raise Skeleton and Raise Skeleton Mage (Sets Golem to 1 Life)"
"increasedwithdex"	"(Based on Dexterity)"
"increasedwithstr"	"(Based on Strength)"
"ModStrBarbWarCry"	"increased Warcry Effect"
"ModStrBarbLtngSkill"	"to Barbarian Lightning Skill Damage"
"ModStrBarbThunder"	"increased Thunderstorm Frequency"
"ModStrBarbFrenzy"	"Frenzy Duration"
"ModStrBarbFrenzy2"	"Frenzy Damage converted to Magic Damage"
"ModStrBarbMagic"	"to Barbarian Magic Melee Skill Damage"
"ModStrDruidBoulder"	"to Molten Boulder Explosion Radius"
"ModStrDruidSpike"	"increased Earth Spikes Frequency and Radius"
"ModStrDruidWolves"	"increased Wolf Damage (x4)"
"ModStrDruidWolves2"	"additional Wolves"
"ModStrDruidCharge"	"additional Bolts released by Charged Claws"
"ModStrDruidShock"	"Additional Shockwave Missiles"
"increasedwithmana"	"(Based on Mana)"
"ModStrSorcTwister"	"Twister Damage also benefits from 1/2 of % Cold Skill Damage"
"Modlife"	"to Life"
"increasedwithenr"	"(Based on Energy)"
"ModStrSorcShower"	"Meteor Shower Frequency"
"Skillname500"	"Bone Circle"
"Skillan500"	"Bone Circle"
"Skillsd500"	"summon a spiraling magic Skull"
"Skillld500"	"spirals outwards damaging enemies it hits\nsummons a magic Skull that"
"Skillname501"	"Devil's Hand"
"Skillan501"	"Devil's Hand"
"Skillsd501"	"\purple;(Necromancer Skill - Curses)\grey;\ndebuff slowing enemies down with additional cold damage"
"Skillld501"	"from icy abyss deeps that will catch enemy's souls\nchannel dark forces to cast a devil's hand"
"Skillname502"	"Minion Explosion"
"Skillan502"	"Minion Explosion"
"Skillsd502"	"\purple;(Necromancer Skill - Summoning Spells)\grey;\ntarget your minion to release two ice waves"
"Skillld502"	"freezing nearby enemies for 1 second\nsacrifice your minion to release two ice waves of death"
"Skillname503"	"Essence Shift"
"Skillan503"	"Essence Shift"
"Skillsd503"	"\purple;(Necromancer Skill - Summoning Spells)\grey;\ninstantly moves to destination and debuff enemies"
"Skillld503"	"reduces enemy's critical chance and attack rating for 2 seconds\nteleports you and your allies releasing a nova that"
"Enemycritred"	"Enemy's Critical Chance: - 25 percent"
"enemyarred"	"Enemy's Attack Rating: "
"cooldowndesc"	"Cooldown: "
"percents"	" percent"
"Skillname504"	"Earthquake"
"Skillan504"	"Earthquake"
"Skillsd504"	"dealing 75% of weapon damage in area\n\red;(requires a Stave or Necromancer Scythe)\grey;"
"Skillld504"	"after 1 sec delay the ground bursts dealing weapon damage to nearby enemies\nsmashes a ground with staff dealing 75% of weapon damage in area\n\red;(requires a Stave or Necromancer Scythe)\grey;"
"Convphy2elemalt"	"Converts %d%% Physical Damage to Magic Damage"
"WeapDamsk"	"Weapon Damage"
"aftershockstr"	"Aftershock deals 100 percent weapon damage"
"Skillname505"	"Cold Embrace"
"Skillan505"	"Cold Embrace"
"Skillsd505"	"\purple;(Amazon Skill - Passive and Magic Skills)\grey;\nbuff yourself with cold winds\n\red;(requires a Bow or Crossbow)\grey;"
"Skillld505"	"chilling them for 2 seconds\nand fires cold arrows at nearby enemies\nbuff increasing your cold and maximum cold resistances\n\red;(requires a Bow or Crossbow)\grey;"
"Skillname506"	"Grim Triangle"
"Skillan506"	"Grim Triangle"
"Skillsd506"	"\purple;(Necromancer Skill - Poison and Bone Spells)\grey;\nputs grim triangle around you\n\red;(requires a Dagger)\grey;"
"Skillld506"	"throwing magic daggers at nearby enemies\nspell - puts a fearful triangle of wards around you\n\red;(requires a Dagger)\grey;"
"Skillname507"	"Stars of Death"
"Skillan507"	"Stars of Death"
"Skillsd507"	"\purple;(Necromancer Skill - Poison and Bone Spells)\grey;\ncreates a pull of poison stars with melee attack\n\red;(requires a Dagger/Necro Scythe)\grey;"
"Skillld507"	"dealing poison damage over time\nrelease green stars on strike \n\red;(requires a Dagger/Necro Scythe)\grey;\n"
"shootstr"	"Release "
"timesstr"	" missile"
"Skillname508"	"Sharp Array"
"Skillan508"	"Sharp Array"
"Skillsd508"	"\purple;(Amazon Skill - Bow and Crossbow Skills)\grey;\ndeadly array of bolts\n\red;(requires a Bow or Crossbow)\grey;"
"Skillld508"	"deadly bolts to all sides\ntarget an enemy to release 3 big arrays of\n\red;(requires a Bow or Crossbow)\grey;"
"Hidden Treasure 9"	"Thunder's Treasure"
"Hidden Treasure 10"	"Dildor's Treasure"
"Hidden Treasure 11"	"Voids's Treasure"
"Hidden Treasure 12"	"Read's Treasure"
"Skillname509"	"Branching Blaze"
"Skillan509"	"Branching Blaze"
"Skillsd509"	"\purple;(Sorceress Skill - Fire Spells)\grey;\nlongrange fireball that splits"
"Skillld509"	"or on impact targeting nearby monsters\nfireball that splits after certain range "
"Skillname510"	"Burning Seekers"
"Skillan510"	"Burning Seekers"
"Skillsd510"	"\purple;(Sorceress Skill - Fire Spells)\grey;\nshortrange firebolt that target nearby monster"
"Skillld510"	"firing multiple missiles\ntarget nearby monsters after a short range "
"Skillname511"	"Fury of the Heavens"
"Skillan511"	"Fury of the Heavens"
"Skillsd511"	"\purple;(Paladin - Combat SkillS)\grey;\nstatic star that deals damage to nearby monsters"
"Skillld511"	"static star that deals magic damage to nearby monsters"
"Skillname512"	"Toxic Spike"
"Skillan512"	"Toxic Spike"
"Skillsd512"	"\purple;(Amazon Skill - Javelin and Spear Skills)\grey;\njavelin that splits or explode on impact\n\red;(requires a Javelin)\grey;"
"Skillld512"	"explode into a poison nova on impact\njavelin that splits after a certain range or\n\red;(requires a Javelin)\grey;"
"increasedwithgold"	"(Based on Extra Gold From Monsters)"
"ModStrAmaHawk"	"to Raven and Fire Hawk Damage"
"ModStrAmaHawk2"	"to Raven and Fire Hawk Crushing Blow"
"coldresstr"	"Cold Resist: "
"maxcoldresstr"	"Maximum Cold Resistance: "
"durationstr"	"Duration: "
"Gheeds Lost Treasure"	"Gheeds Lost Treasure"
"toadesc"	"Right click to reset all skill and stat points"
"ModStrPalaBolt"	"Additional Holy Bolt Missiles"
"ModStrPalaTick"	"Increase Holy Aura's Tick Rate by"
"Skillname513"	"Gale Bearer"
"Skillan513"	"Gale Bearer"
"Skillsd513"	"\purple;(Paladin - Combat Skills)\grey;\nrelease lightning bolts from sky on attack\n\red;Requires Melee Weapon\grey;"
"Skillld513"	"bolts on random foes around your target\nhits an enemy to release deadly lightning\nConverts 100 percent of weapon damage to lightning\n\red;Requires Melee Weapon\grey;"
"Skillname514"	"Icy Pest"
"Skillan514"	"Icy Pest"
"Skillsd514"	"\purple;(Paladin - Combat Skills)\grey;\nHit an enemy to spread a chilling plague around\n\red;Requires Melee Weapon\grey;"
"Skillld514"	"Spreads chilling plague through enemies around you\n\red;Requires Melee Weapon\grey;"
"Skillname515"	"Shards of Hellfire"
"Skillan515"	"Shards of Hellfire"
"Skillsd515"	"\purple;(Paladin - Combat Skills)\grey;\nmelee attack releasing homing shards of fire\n\red;Requires Melee Weapon\grey;"
"Skillld515"	"shards of hellfire seeking around\nhits an enemy with burning rage releasing multiple\nConverts 100 percent of weapon damage to fire\n\red;Requires Melee Weapon\grey;"
"Skillname516"	"Rude Offense"
"Skillan516"	"Rude Offense"
"Skillsd516"	"teleport with knockback nova"
"Skillld516"	"knocking back enemies dealing magic damage \nteleport yourself releasing a nova \n"
"ModStrPalaTele"	"Rude Offense Castdelay Reduction"
"Skillname517"	"Shield Throw"
"Skillan517"	"Shield Throw"
"Skillsd517"	"throw your shield to crush them all\n\red;Requires Shield\grey;"
"Skillld517"	"100% of weapon damage\nAffected by "
"Convphy2elemalt"	"Converts %d%% Physical Damage to Magic Damage"
"t76"	"output: \red;Orb of Corruption\grey;\nCube to select output\nCube with a key to extract\nCube with a material to store"
"t62"	"output: \dgrey;Fang\grey;\nCube to select output\nCube with a key to extract\nCube with a material to store"
"StrSkillA1"	" shield(s) thrown"
"Skillname518"	"Sculptor of Suns"
"Skillan518"	"Sculptor of Suns"
"Skillsd518"	"\purple;(Paladin - Combat Skills)\grey;\nattack enemy to release balls of lightning around you\n\red;Requires Sword, Mace or Hammer\grey;"
"Skillld518"	"dealing half of your weapon damage and additional lightning damage\nmelee attack that releases a ring of electrical balls around you\nHits Up To 8 Times Per Second\n\red;Requires Sword, Mace or Hammer\grey;"
"Skillname519"	"Field of Battle"
"Skillan519"	"Field of Battle"
"Skillsd519"	"\purple;(Assassin Skill - Traps)\grey;\ntrap-spawning strike\n\red;Requires Claw\grey;"
"Skillld519"	"emitting shurikens piercing monsters\nhit an enemy to spawn a static trap\n\red;Requires Claw\grey;"
"Skillname520"	"Behemoth Skin"
"Skillan520"	"Behemoth Skin"
"Skillsd520"	"\purple;(Assassin Skill - Shadow Discipline)\grey;\nmelee buff"
"Skillld520"	"the ability to pierce enemy's skin\nphysical resistance and armor while giving you\na buff - makes your skin harder raising"
"Skillname521"	"Temple of Fury"
"Skillan521"	"Temple of Fury"
"Skillsd521"	"\purple;(Assassin Skill - Traps)\grey;\nplace a spawner which drops lightning bombs around it"
"Skillld521"	"lightning bombs at nearby enemies\nplants an essense of thunderous wrath that throws\nHits Up To 8 Times Per Second"
"Skillname522"	"Blade Fission"
"Skillan522"	"Blade Fission"
"Skillsd522"	"\purple;(Assassin Skill - Martial Arts)\grey;\nsplitting knife\n\red;Requires Throwing Knife\grey;"
"Skillld522"	"into multiple deadly knives\nthrows a knife that splits on hit\n\red;Requires Throwing Knife\grey;"
"physpiercestr"	"Pierces Enemy's Physical Resistance By "
"percentwdmstr"	"% Weapon Damage"
"totalknivecountstr"	"Knives Released: "
"StrSkill181"	"Physical Damage Taken Reduced By: "
"basedefstr"	"Base Defense "
"of Reassembling"	"of Reassembling"
"of the Underworld"	"of the Underworld"
"of Fire Bolts"	"of Burning Seekers"
"of Branching Blaze"	"of Fire Balls"
"ModStrMinion2"	"additional Fire Golem, Valkyrie and Shadow Master"
"ModStrBlood"	"Bloody"
"ModSorcBolt"	"1 Fire and Ice Bolt Missile per 5 Basepoints instead of 15"
"ModStrNecSpear"	"Additional Bone Spear Missiles"
"Dfuzzz's Fingerguard 1"	"Dfuzzz's Fingerguard"
"Dfuzzz's Fingerguard 2"	"Dfuzzz's Fingerguard"
"Killashandra Ree's Black C 1"	"Killashandra Ree's Black Crystal"
"Killashandra Ree's Black C 2"	"Killashandra Ree's Black Crystal"
"BlackMage's Knucklebone 1"	"BlackMage's Knucklebone"
"BlackMage's Knucklebone 2"	"BlackMage's Knucklebone"
"The Tipsy Donut 1"	"The Tipsy Donut"
"The Tipsy Donut 2"	"The Tipsy Donut"
"Brennus's Plunder 1"	"Brennus's Plunder"
"Brennus's Plunder 2"	"Brennus's Plunder"
"Yagul's Wrath 1"	"Yagul's Wrath"
"Yagul's Wrath 2"	"Yagul's Wrath"
"Killjoy's Attitude 1"	"Killjoy's Attitude"
"Killjoy's Attitude 2"	"Killjoy's Attitude"
"Soulstone"	"Soulstone"
"increaseswithvit"	"(Based on Vitality)"
"Dark Universe"	"Dark Universe"
"hiddendesc"	"\red;Cannot be rerolled"
"StrSkillLowerRes"	"\yellow;Pierces Enemy Resists By 1% Per Base Point\grey;"
"StrSkillPoisonMas"	"\yellow;Pierces Enemy Resists By 1% Per Base Point\grey;"
"StrSkillAmplifyDmg"	"\yellow;Pierces Enemy Resist By 1% Per Base Point\grey;"
"StrSkillInnerCorr"	"\yellow;Pierces Enemy Resists By 2% Per Base Point\grey;"
"StrSkillHorrForm"	"\yellow;Pierces Enemy Resists By 1% Per Base Point\grey;"
"StrSkillAthenaPre"	"\yellow;Pierces Enemy Resists By 1% Per Base Point\grey;"
"StrSkillConviction"	"\yellow;Pierces Enemy Resists By 1% Per Base Point\grey;"
"StrSkillPoisCreeper"	"\yellow;Pierces Enemy Resist By 1% Per Base Point\grey;"
"StrSkillFireCreeper"	"\yellow;Pierces Enemy Resist By 1% Per Base Point\grey;"
"StrSkillColdCreeper"	"\yellow;Pierces Enemy Resist By 1% Per Base Point\grey;"
"strModAllResistances2"	"All Resistances"
"0s1"	"Alder Twig"
"0s2"	"Alder Branch"
"0s3"	"Alder Bough"
"Sturdy"	"Sturdy"
"Strong"	"Strong"
"Glorious"	"Glorious"
"Blessed"	"Blessed"
"Godly"	"Godly"
"Stout"	"Stout"
"Burly"	"Burly"
"Stalwart"	"Stalwart"
"Saintly"	"Saintly"
"Holy"	"Holy"
"Armadillo's"	"Armadillo's"
"Rhino's"	"Rhino's"
"Elephant's"	"Elephant's"
"Mammoth's"	"Mammoth's"
"Fecund"	"Fecund"
"Rapturous"	"Rapturous"
"Vigorous"	"Vigorous"
"Prime"	"Prime"
"Virile"	"Virile"
"Vivid"	"Vivid"
"Gladiator's"	"Gladiator's"
"Legend's"	"Legend's"
"Brisk"	"Brisk"
"Swift"	"Swift"
"Lizard's"	"Lizard's"
"Snake's"	"Snake's"
"Serpent's"	"Serpent's"
"Wyrm's"	"Wyrm's"
"Great Wyrm's"	"Great Wyrm's"
"Sage"	"Sage"
"Omniscient"	"Omniscient"
"Pixie's"	"Pixie's"
"Seraphim's"	"Seraphim's"
"Djinn's"	"Djinn's"
"Rainbow"	"Rainbow"
"Shimmering"	"Shimmering"
"Scintillating"	"Scintillating"
"Prismatic"	"Prismatic"
"Chromatic"	"Chromatic"
"Azure"	"Azure"
"Lapis"	"Lapis"
"Cobalt"	"Cobalt"
"Sapphire"	"Sapphire"
"Lapis Lazuli"	"Lapis Lazuli"
"Crimson"	"Crimson"
"Russet"	"Russet"
"Garnet"	"Garnet"
"Ruby"	"Ruby"
"Tangerine"	"Tangerine"
"Ocher"	"Ocher"
"Coral"	"Coral"
"Amber"	"Amber"
"Ambergris"	"Ambergris"
"Beryl"	"Beryl"
"Viridian"	"Viridian"
"Jade"	"Jade"
"Emerald"	"Emerald"
"Amazonit"	"Amazonit"
"Corundum"	"Corundum"
"Diamond"	"Diamond"
"Bathyal"	"Bathyal"
"Abyssal"	"Abyssal"
"Hadal"	"Hadal"
"Unseen"	"Unseen"
"Barricaded"	"Barricaded"
"Bulwarked"	"Bulwarked"
"Bastioned"	"Bastioned"
"Buttressed"	"Buttressed"
"Jagged"	"Jagged"
"Massive"	"Massive"
"Savage"	"Savage"
"Ravening"	"Ravening"
"Ferocious"	"Ferocious"
"Deadly"	"Deadly"
"Vicious"	"Vicious"
"Brutal"	"Brutal"
"Merciless"	"Merciless"
"Warrior's"	"Warrior's"
"Soldier's"	"Soldier's"
"Knight's"	"Knight's"
"Lord's"	"Lord's"
"Glinting"	"Glinting"
"Polished"	"Polished"
"Gleaming"	"Gleaming"
"Tempered"	"Tempered"
"Relentless"	"Relentless"
"Burnished"	"Burnished"
"Honed"	"Honed"
"Annealed"	"Annealed"
"Flaring"	"Flaring"
"Unforgiving"	"Unforgiving"
"Squire's"	"Squire's"
"Reaver's"	"Reaver's"
"Conqueror's"	"Conqueror's"
"Dictator's"	"Dictator's"
"Tyrant's"	"Tyrant's"
"Combatant's"	"Combatant's"
"Journeyman's"	"Journeyman's"
"Mercenary's"	"Mercenary's"
"Emperor's"	"Emperor's"
"Imperator's"	"Imperator's"
"Screaming"	"Screaming"
"Howling"	"Howling"
"Wailing"	"Wailing"
"Shrieking"	"Shrieking"
"Unchained"	"Unchained"
"Empowering"	"Empowering"
"Overpowering"	"Overpowering"
"Wounding"	"Wounding"
"Unleashed"	"Unleashed"
"Devastating"	"Devastating"
"Ronald's"	"Ronald's"
"Kron's"	"Kron's"
"Volcazar's"	"Volcazar's"
"Zaal's"	"Zaal's"
"Frosted"	"Frosted"
"Chilled"	"Chilled"
"Glaciated"	"Glaciated"
"Entombing"	"Entombing"
"Crystallizing"	"Crystallizing"
"Heated"	"Heated"
"Smouldering"	"Smouldering"
"Flaming"	"Flaming"
"Scorching"	"Scorching"
"Cremating"	"Cremating"
"Humming"	"Humming"
"Crackling"	"Crackling"
"Arcing"	"Arcing"
"Electrocuting"	"Electrocuting"
"Vapourising"	"Vapourising"
"Septic"	"Septic"
"Foul"	"Foul"
"Corrosive"	"Corrosive"
"Toxic"	"Toxic"
"Pestilent"	"Pestilent"
"Boreal"	"Boreal"
"Hibernal"	"Hibernal"
"Fiery"	"Fiery"
"Ignited"	"Ignited"
"Arctic"	"Arctic"
"Frigid"	"Frigid"
"Frizzling"	"Frizzling"
"Zapping"	"Zapping"
"Hellish"	"Hellish"
"Infernal"	"Infernal"
"Fuming"	"Fuming"
"Blistering"	"Blistering"
"Boiling"	"Boiling"
"Firebreathing"	"Firebreathing"
"Immolating"	"Immolating"
"Numbing"	"Numbing"
"Biting"	"Biting"
"Icy"	"Icy"
"Alpine"	"Alpine"
"Burying"	"Burying"
"Glowing"	"Glowing"
"Static"	"Static"
"Bolting"	"Bolting"
"Striking"	"Striking"
"Vanishing"	"Vanishing"
"Paralyzing"	"Paralyzing"
"Crippling"	"Crippling"
"Infecting"	"Infecting"
"Coroding"	"Coroding"
"Dissolving"	"Dissolving"
"Consecrated"	"Consecrated"
"Sacred"	"Sacred"
"Hallowed"	"Hallowed"
"Divine"	"Divine"
"Celestial"	"Celestial"
"Breezy"	"Breezy"
"Stormy"	"Stormy"
"Windswept"	"Windswept"
"Blusterous"	"Blusterous"
"Weltering"	"Weltering"
"Persisting"	"Persisting"
"Perennial"	"Perennial"
"Ageless"	"Ageless"
"Undying"	"Undying"
"Imperishable"	"Imperishable"
"Blazing"	"Blazing"
"Incinerating"	"Incinerating"
"Annihilating"	"Annihilating"
"Frosty"	"Frosty"
"Frozen"	"Frozen"
"Polar"	"Polar"
"Hyperborean"	"Hyperborean"
"Sizzling"	"Sizzling"
"Parching"	"Parching"
"Ionising"	"Ionising"
"Torrid"	"Torrid"
"Virulent"	"Virulent"
"Nocuous"	"Nocuous"
"Malicious"	"Malicious"
"Contaminating"	"Contaminating"
"Stellar"	"Stellar"
"Seraphic"	"Seraphic"
"Revered"	"Revered"
"Cherubic"	"Cherubic"
"Gusting"	"Gusting"
"Hailing"	"Hailing"
"Wuthering"	"Wuthering"
"Tempestuous"	"Tempestuous"
"Iguana's"	"Iguana's"
"Zilant's"	"Zilant's"
"Wyvern's"	"Wyvern's"
"Monitor Lizard's"	"Monitor Lizard's"
"Quetzalcoatl's"	"Quetzalcoatl's"
"Ophidian's"	"Ophidian's"
"Kukulkan's"	"Kukulkan's"
"Erudite's"	"Erudite's"
"Sagacious"	"Sagacious"
"Motley"	"Motley"
"Coruscating"	"Coruscating"
"Polychromatic"	"Polychromatic"
"Variegated"	"Variegated"
"Kaleidoscopic"	"Kaleidoscopic"
"Decaying"	"Decaying"
"Putrescent"	"Putrescent"
"Putrid"	"Putrid"
"Festering"	"Festering"
"Flyblown"	"Flyblown"
"Leprechaun's"	"Leprechaun's"
"Hobgoblin's"	"Hobgoblin's"
"Archfiend's"	"Archfiend's"
"Vital"	"Vital"
"Fertile"	"Fertile"
"Lush"	"Lush"
"Lavish"	"Lavish"
"Posh"	"Posh"
"Zaffre"	"Zaffre"
"Cerulean"	"Cerulean"
"Glaucous"	"Glaucous"
"Ultramarine"	"Ultramarine"
"Periwinkle"	"Periwinkle"
"Opulent"	"Opulent"
"Sumptuous"	"Sumptuous"
"Terisiare's"	"Terisiare's"
"Kaldheim's"	"Kaldheim's"
"Keldon's"	"Keldon's"
"Balduvian's"	"Balduvian's"
"Chandra's"	"Chandra's"
"Ghitu's"	"Ghitu's"
"Shiv's"	"Shiv's"
"Bogardan's"	"Bogardan's"
"Rousing"	"Rousing"
"Roaring"	"Roaring"
"Thunderous"	"Thunderous"
"Deafening"	"Deafening"
"Bezoar"	"Bezoar"
"Hornbill"	"Hornbill"
"Celadon"	"Celadon"
"Mithridates"	"Mithridates"
"Stone"	"Stone"
"Bronze"	"Bronze"
"Iron"	"Iron"
"Ravaging"	"Ravaging"
"Seething"	"Seething"
"Searing"	"Searing"
"Wintry"	"Wintry"
"Shivering"	"Shivering"
"Gelid"	"Gelid"
"Chaining"	"Chaining"
"Forking"	"Forking"
"Homing"	"Homing"
"Toad's"	"Toad's"
"Cockatrice's"	"Cockatrice's"
"Basilisk's"	"Basilisk's"
"Devout"	"Devout"
"Pious"	"Pious"
"Virtuous"	"Virtuous"
"Windscouter's"	"Windscouter's"
"Windseeker's"	"Windseeker's"
"Windrider's"	"Windrider's"
"Gnawing"	"Gnawing"
"Munching"	"Munching"
"Devouring"	"Devouring"
"Hellhound's"	"Hellhound's"
"Cherufe's"	"Cherufe's"
"Basan's"	"Basan's"
"Ijiraq's"	"Ijiraq's"
"Qiqirn's"	"Qiqirn's"
"Amarok's"	"Amarok's"
"Thunderbird's"	"Thunderbird's"
"Raiju's"	"Raiju's"
"Raijin's"	"Raijin's"
"Lavellan's"	"Lavellan's"
"Zhenniao's"	"Zhenniao's"
"Manticore's"	"Manticore's"
"Baku's"	"Baku's"
"Satori's"	"Satori's"
"Oni's"	"Oni's"
"Onryo's"	"Onryo's"
"Machai's"	"Machai's"
"Wendigo's"	"Wendigo's"
"Frore"	"Frore"
"Rimy"	"Rimy"
"Algid"	"Algid"
"Crepitating"	"Crepitating"
"Snapping"	"Snapping"
"Glistening"	"Glistening"
"Stygian"	"Stygian"
"Chthonic"	"Chthonic"
"Tartarean"	"Tartarean"
"Gelid"	"Gelid"
"Hiemal"	"Hiemal"
"Adarkar's"	"Adarkar's"
"Rutilant"	"Rutilant"
"Incandescent"	"Incandescent"
"Hellkite's"	"Hellkite's"
"Nebulous"	"Nebulous"
"Misty"	"Misty"
"Opaque"	"Opaque"
"Defiled"	"Defiled"
"Tainted"	"Tainted"
"Ravished"	"Ravished"
"Broiling"	"Broiling"
"Lighted"	"Lighted"
"Harsh"	"Harsh"
"Siberian"	"Siberian"
"Fulgurous"	"Fulgurous"
"Fulminous"	"Fulminous"
"Mordacious"	"Mordacious"
"Mordant"	"Mordant"
"Satanic"	"Satanic"
"Fiendish"	"Fiendish"
"Sanguinary"	"Sanguinary"
"Mortal"	"Mortal"
"Trenchant"	"Trenchant"
"Scathing"	"Scathing"
"Scornful"	"Scornful"
"Cruel"	"Cruel"
"Barbaric"	"Barbaric"
"Barbarous"	"Barbarous"
"Ruthless"	"Ruthless"
"Bestial"	"Bestial"
"Unbroken"	"Unbroken"
"Iridal"	"Iridal"
"Catalysing"	"Catalysing"
"Loathsome"	"Loathsome"
"Odious"	"Odious"
"Chalybeous"	"Chalybeous"
"Gentian"	"Gentian"
"Opalescent"	"Opalescent"
"Cool"	"Cool"
"Snowy"	"Snowy"
"Hypothermic"	"Hypothermic"
"Charred"	"Charred"
"Red-Hot"	"Red-Hot"
"White-Hot"	"White-Hot"
"Pulsating"	"Pulsating"
"Oscillating"	"Oscillating"
"Reverberating"	"Reverberating"
"Malignant"	"Malignant"
"Morbid"	"Morbid"
"Diseased"	"Diseased"
"Slushy"	"Slushy"
"Brumal"	"Brumal"
"Bleak"	"Bleak"
"Combusted"	"Combusted"
"Torching"	"Torching"
"Carbonizing"	"Carbonizing"
"Flickering"	"Flickering"
"Dazzling"	"Dazzling"
"Glittering"	"Glittering"
"Pernicious"	"Pernicious"
"Pestilential"	"Pestilential"
"Malevolent"	"Malevolent"
"Atrocious"	"Atrocious"
"Abhorrent"	"Abhorrent"
"Revolting"	"Revolting"
"Heinous"	"Heinous"
"Hateful"	"Hateful"
"Horrible"	"Horrible"
"Impish"	"Impish"
"Devilish"	"Devilish"
"Horrifying"	"Horrifying"
"Callous"	"Callous"
"Soulless"	"Soulless"
"Lifeless"	"Lifeless"
"Aquamarine"	"Aquamarine"
"Turquoise"	"Turquoise"
"Larimar"	"Larimar"
"Carnelian"	"Carnelian"
"Cuprite"	"Cuprite"
"Sunstone"	"Sunstone"
"Moonstone"	"Moonstone"
"Celestite"	"Celestite"
"Angelite"	"Angelite"
"Peridot"	"Peridot"
"Parasolite"	"Parasolite"
"Malachite"	"Malachite"
"Lively"	"Lively"
"Zestful"	"Zestful"
"Effervescent"	"Effervescent"
"Esoteric"	"Esoteric"
"Mystifying"	"Mystifying"
"Ephemeral"	"Ephemeral"
"Spectral"	"Spectral"
"Vibrant"	"Vibrant"
"Iridescent"	"Iridescent"
"Shielded"	"Shielded"
"Ironclad"	"Ironclad"
"Impenetrable"	"Impenetrable"
"Warded"	"Warded"
"Impervious"	"Impervious"
"Spellproof"	"Spellproof"
"Robust"	"Robust"
"Enduring"	"Enduring"
"Resilient"	"Resilient"
"Pointed"	"Pointed"
"Fanged"	"Fanged"
"Bristling"	"Bristling"
"Awful"	"Awful"
"Nippy"	"Nippy"
"Bone-Chilling"	"Bone-Chilling"
"Ice-Cold"	"Ice-Cold"
"Feverish"	"Feverish"
"Sultry"	"Sultry"
"Roasting"	"Roasting"
"Overcast"	"Overcast"
"Ominous"	"Ominous"
"Turbulent"	"Turbulent"
"Viral"	"Viral"
"Pathogenic"	"Pathogenic"
"Lethal"	"Lethal"
"Hasty"	"Hasty"
"Dashing"	"Dashing"
"Racing"	"Racing"
"Inflammable"	"Inflammable"
"Pyrophilic"	"Pyrophilic"
"Crystallized"	"Crystallized"
"Frostbitten"	"Frostbitten"
"Susceptible"	"Susceptible"
"Conductive"	"Conductive"
"Weakening"	"Weakening"
"Infectuous"	"Infectuous"
"Bewitchable"	"Bewitchable"
"Spellbound"	"Spellbound"
"Defenseless"	"Defenseless"
"Vulnerable"	"Vulnerable"
"of Might"	"of Might"
"of the Ox"	"of the Ox"
"of the Giant"	"of the Giant"
"of the Titan"	"of the Titan"
"of Atlas"	"of Atlas"
"of the Phantom"	"of the Phantom"
"of the Wind"	"of the Wind"
"of Precision"	"of Precision"
"of Perfection"	"of Perfection"
"of Nirvana"	"of Nirvana"
"of the Mind"	"of the Mind"
"of Brilliance"	"of Brilliance"
"of Sorcery"	"of Sorcery"
"of Wizardry"	"of Wizardry"
"of Enlightenment"	"of Enlightenment"
"of the Jackal"	"of the Jackal"
"of the Wolf"	"of the Wolf"
"of the Tiger"	"of the Tiger"
"of the Colossus"	"of the Colossus"
"of the Whale"	"of the Whale"
"of the Bear"	"of the Bear"
"of the Gorilla"	"of the Gorilla"
"of the Jaguar"	"of the Jaguar"
"of the Panther"	"of the Panther"
"of the Prodigy"	"of the Prodigy"
"of the Genius"	"of the Genius"
"of the Squid"	"of the Squid"
"of the Mumakil"	"of the Mumakil"
"of Velocity"	"of Velocity"
"of Acceleration"	"of Acceleration"
"of Blocking"	"of Blocking"
"of Deflecting"	"of Deflecting"
"of Balance"	"of Balance"
"of Stability"	"of Stability"
"of Regeneration"	"of Regeneration"
"of Regrowth"	"of Regrowth"
"of the Psyche"	"of the Psyche"
"of Euphoria"	"of Euphoria"
"of Ages"	"of Ages"
"of Eternity"	"of Eternity"
"of Blitz Armor"	"of Blitz Armor"
"of Fire Armor"	"of Fire Armor"
"of Shiver Armor"	"of Shiver Armor"
"of Ease"	"of Ease"
"of Simplicity"	"of Simplicity"
"of Alleviation"	"of Alleviation"
"of Greed"	"of Greed"
"of Plunder"	"of Plunder"
"of Fortune"	"of Fortune"
"of Riches"	"of Riches"
"of the Whelpling"	"of the Whelpling"
"of the Kiln"	"of the Kiln"
"of the Walrus"	"of the Walrus"
"of the Polar Bear"	"of the Polar Bear"
"of the Tempest"	"of the Tempest"
"of the Maelstrom"	"of the Maelstrom"
"of Flames"	"of Flames"
"of Immolation"	"of Immolation"
"of Shock"	"of Shock"
"of Zapping"	"of Zapping"
"of Chilling"	"of Chilling"
"of Freezing"	"of Freezing"
"of Blight"	"of Blight"
"of Venom"	"of Venom"
"of Banishment"	"of Banishment"
"of Exile"	"of Exile"
"of Dazing"	"of Dazing"
"of Impact"	"of Impact"
"of Knowledge"	"of Knowledge"
"of Dogma"	"of Dogma"
"of Archaeology"	"of Archaeology"
"of Excavation"	"of Excavation"
"of Exhuming"	"of Exhuming"
"of the Oiorpata"	"of the Oiorpata"
"of Thorns"	"of Thorns"
"of Spikes"	"of Spikes"
"of Razors"	"of Razors"
"of Swords"	"of Swords"
"of Shade Armor"	"of Shade Armor"
"of Haer Dalis"	"of Haer Dalis"
"of the Apprentice"	"of the Apprentice"
"of the Mage"	"of the Mage"
"of the Arch Mage"	"of the Arch Mage"
"of the Royal Wizard"	"of the Royal Wizard"
"of the Clouds"	"of the Clouds"
"of the Sky"	"of the Sky"
"of the Heavens"	"of the Heavens"
"of Slaying"	"of Slaying"
"of Destruction"	"of Destruction"
"of Carnage"	"of Carnage"
"of Crushing"	"of Crushing"
"of Mighty"	"of Mighty"
"of the Bull"	"of the Bull"
"of the Ogre"	"of the Ogre"
"of the Goliath"	"of the Goliath"
"of Prometheus"	"of Prometheus"
"of the Spectre"	"of the Spectre"
"of the Gale"	"of the Gale"
"of the Falcon"	"of the Falcon"
"of Excellence"	"of Excellence"
"of Oblivion"	"of Oblivion"
"of Lucidity"	"of Lucidity"
"of Luminosity"	"of Luminosity"
"of Incantation"	"of Incantation"
"of Conjuration"	"of Conjuration"
"of Awakening"	"of Awakening"
"of the Ursus"	"of the Ursus"
"of the Chimpanzee"	"of the Chimpanzee"
"of the Leopard"	"of the Leopard"
"of the Cheetah"	"of the Cheetah"
"of the Oracle"	"of the Oracle"
"of Virtuosity"	"of Virtuosity"
"of Readiness"	"of Readiness"
"of Alacrity"	"of Alacrity"
"of Swiftness"	"of Swiftness"
"of Quickness"	"of Quickness"
"of Fervour"	"of Fervour"
"of the Magus"	"of the Magus"
"of the Conjurer"	"of the Conjurer"
"of the Diviner"	"of the Diviner"
"of the Foreseer"	"of the Foreseer"
"of the Visionary"	"of the Visionary"
"of the Leech"	"of the Leech"
"of the Locust"	"of the Locust"
"of the Lamprey"	"of the Lamprey"
"of the Bat"	"of the Bat"
"of the Wraith"	"of the Wraith"
"of the Vampire"	"of the Vampire"
"of the Bloodmad"	"of the Bloodmad"
"of the Bloodsworn"	"of the Bloodsworn"
"of the Bloodlord"	"of the Bloodlord"
"of Mana Leak"	"of Mana Leak"
"of Mana Drain"	"of Mana Drain"
"of Mana Breach"	"of Mana Breach"
"of the Deathless"	"of the Deathless"
"of the Deathbringer"	"of the Deathbringer"
"of the Deathmark"	"of the Deathmark"
"of Mauling"	"of Mauling"
"of the Mauler"	"of the Mauler"
"of the Maulhorn"	"of the Maulhorn"
"of Fire Balls"	"of Fire Balls"
"of Fire Bolts"	"of Fire Bolts"
"of Chain Lightning"	"of Chain Lightning"
"of Plasma Rain"	"of Plasma Rain"
"of Ice Fangs"	"of Ice Fangs"
"of Blizzard"	"of Blizzard"
"of Poison Nova"	"of Poison Nova"
"of Earth Spikes"	"of Earth Spikes"
"of Restoration"	"of Restoration"
"of Regrowth"	"of Regrowth"
"of Rejuvenation"	"of Rejuvenation"
"of Resurgence"	"of Resurgence"
"of Conviction"	"of Conviction"
"of Doctrine"	"of Doctrine"
"of Law"	"of Law"
"of Ideology"	"of Ideology"
"of Aeons"	"of Aeons"
"of the Dullahan"	"of the Dullahan"
"of Callisto"	"of Callisto"
"of Jambavan"	"of Jambavan"
"of Otso"	"of Otso"
"of Ayula"	"of Ayula"
"of the Onikuma"	"of the Onikuma"
"of Orthrus"	"of Orthrus"
"of Asena"	"of Asena"
"of Cerebus"	"of Cerebus"
"of the Chupacabra"	"of the Chupacabra"
"of Fenrir"	"of Fenrir"
"of the Griffin"	"of the Griffin"
"of the Salmon"	"of the Salmon"
"of the Sphinx"	"of the Sphinx"
"of Baize"	"of Baize"
"of Athena"	"of Athena"
"of the Faun"	"of the Faun"
"of the Nymph"	"of the Nymph"
"of the Satyr"	"of the Satyr"
"of the Incubus"	"of the Incubus"
"of the Succubus"	"of the Succubus"
"of Steadiness "	"of Steadiness "
"of Composure"	"of Composure"
"of Speed"	"of Speed"
"of Celerity"	"of Celerity"
"of Intelligence"	"of Intelligence"
"of Perception"	"of Perception"
"of the Carbuncle"	"of the Carbuncle"
"of the Leprechaun"	"of the Leprechaun"
"of the Drawf"	"of the Drawf"
"of the Sarimanok"	"of the Sarimanok"
"of Sengir"	"of Sengir"
"of Falkenrath"	"of Falkenrath"
"of Voldaren"	"of Voldaren"
"of Malakir"	"of Malakir"
"of Markov"	"of Markov"
"of Stormkirk"	"of Stormkirk"
"of the Bloodseeker"	"of the Bloodseeker"
"of the Bloodcrazed"	"of the Bloodcrazed"
"of the Bloodfire"	"of the Bloodfire"
"of Mana Geyser"	"of Mana Geyser"
"of Mana Flare"	"of Mana Flare"
"of Mana Echoes"	"of Mana Echoes"
"of the Simurgh"	"of the Simurgh"
"of the Phoenix"	"of the Phoenix"
"of the Vault"	"of the Vault"
"of the Crypt"	"of the Crypt"
"of Belief"	"of Belief"
"of Faith"	"of Faith"
"of Mettle"	"of Mettle"
"of Fortitude"	"of Fortitude"
"of Determination"	"of Determination"
"of the Mongoose"	"of the Mongoose"
"of the Lynx"	"of the Lynx"
"of the Meerkat"	"of the Meerkat"
"of Divination"	"of Divination"
"of Prediction"	"of Prediction"
"of Augury"	"of Augury"
"of Brio"	"of Brio"
"of Intensity"	"of Intensity"
"of Fervour"	"of Fervour"
"of Eruption"	"of Eruption"
"of Explosion"	"of Explosion"
"of Detonation"	"of Detonation"
"of Frigidity"	"of Frigidity"
"of Frostbite"	"of Frostbite"
"of Glaciation"	"of Glaciation"
"of Thunderstroke"	"of Thunderstroke"
"of Thunderbolt"	"of Thunderbolt"
"of Thunderstorm"	"of Thunderstorm"
"of Bane"	"of Bane"
"of Contagion"	"of Contagion"
"of Sepsis"	"of Sepsis"
"of Profanity"	"of Profanity"
"of Desecration"	"of Desecration"
"of Sacrilege"	"of Sacrilege"
"of Gale"	"of Gale"
"of Typhoon"	"of Typhoon"
"of Hurricane"	"of Hurricane"
"of Coinage"	"of Coinage"
"of Wealth"	"of Wealth"
"of Treasure"	"of Treasure"
"of Alchemy"	"of Alchemy"
"of Allurement"	"of Allurement"
"of Thaumaturgy"	"of Thaumaturgy"
"of Zeal"	"of Zeal"
"of Ardour"	"of Ardour"
"of Evenness"	"of Evenness"
"of Counterpoise"	"of Counterpoise"
"of Nimbleness"	"of Nimbleness"
"of Expertise"	"of Expertise"
"of Blasphemy"	"of Blasphemy"
"of Execration"	"of Execration"
"of Frost Nova"	"of Frost Nova"
"of Firestorm"	"of Firestorm"
"of Charged Bolt"	"of Charged Bolt"
"of Bone Spear"	"of Bone Spear"
"of the Tiger"	"of the Tiger"
"of the Cougar"	"of the Cougar"
"of the Smilodon"	"of the Smilodon"
"of the Ostrich"	"of the Ostrich"
"of the Pronghorns"	"of the Pronghorns"
"of th Eagle"	"of th Eagle"
"of Cultivation"	"of Cultivation"
"of Insight"	"of Insight"
"of Vision"	"of Vision"
"of the Rhinoceros"	"of the Rhinoceros"
"of the Tapir"	"of the Tapir"
"of the Moa"	"of the Moa"
"of Haste"	"of Haste"
"of Fleetness"	"of Fleetness"
"of Puncture"	"of Puncture"
"of Rupture"	"of Rupture"
"of the Mosquito"	"of the Mosquito"
"of the Anopheles"	"of the Anopheles"
"of the Hunter"	"of the Hunter"
"of the Falconer"	"of the Falconer"
"of the Squirrel"	"of the Squirrel"
"of the Gecko"	"of the Gecko"
"of the Gazelle"	"of the Gazelle"
"of the Boar"	"of the Boar"
"of the Elephant"	"of the Elephant"
"of the Bison"	"of the Bison"
"of the Scholar"	"of the Scholar"
"of the Mentor"	"of the Mentor"
"of Radiance"	"of Radiance"
"of the Donkey"	"of the Donkey"
"of the Mule"	"of the Mule"
"of the Centaur"	"of the Centaur"
"of the Weasel"	"of the Weasel"
"of the Cat"	"of the Cat"
"of the Grizzly"	"of the Grizzly"
"of Hyperion"	"of Hyperion"
"of Intuition"	"of Intuition"
"of Wisdom"	"of Wisdom"
"of the Manatee"	"of the Manatee"
"of the Orca"	"of the Orca"
"of Ignition"	"of Ignition"
"of Conflagration"	"of Conflagration"
"of Current"	"of Current"
"of the Stormcloud"	"of the Stormcloud"
"of the Icicle"	"of the Icicle"
"of Permafrost"	"of Permafrost"
"of Malady"	"of Malady"
"of Miasma"	"of Miasma"
"of Obscenety"	"of Obscenety"
"of Vulgarity"	"of Vulgarity"
"of the Breeze"	"of the Breeze"
"of the Cyclone"	"of the Cyclone"
"of Bounty"	"of Bounty"
"of Prosperity"	"of Prosperity"
"of the Hoard"	"of the Hoard"
"of Fate"	"of Fate"
"of the Rabbit's Foot"	"of the Rabbit's Foot"
"of the Treasury"	"of the Treasury"
"of the Incense"	"of the Incense"
"of the Forge"	"of the Forge"
"of the Penguin"	"of the Penguin"
"of the Snow Rabbit"	"of the Snow Rabbit"
"of Nimbus"	"of Nimbus"
"of Discharge"	"of Discharge"
"of Refreshment"	"of Refreshment"
"of Revitalization"	"of Revitalization"
"of Counterbalance"	"of Counterbalance"
"of Equilibrium"	"of Equilibrium"
"of the Yamabushi"	"of the Yamabushi"
"of Sokenzan"	"of Sokenzan"
"of the Moonfolk"	"of the Moonfolk"
"of Otawara"	"of Otawara"
"of the Nezumi"	"of the Nezumi"
"of Shizo"	"of Shizo"
"of the Samurai"	"of the Samurai"
"of Eiganjo"	"of Eiganjo"
"of the Sanzoku"	"of the Sanzoku"
"of Shinka"	"of Shinka"
"of the Monk"	"of the Monk"
"of Okina"	"of Okina"
"of the Ronin"	"of the Ronin"
"of Takenuma"	"of Takenuma"
"Stabbing"	"Stabbing"
"Impaling"	"Impaling"
"Righteous"	"Righteous"
"Devoted"	"Devoted"
"Radiant"	"Radiant"
"Sublime"	"Sublime"
"Exalted"	"Exalted"
"Profane"	"Profane"
"Unhallowed"	"Unhallowed"
"Cherubic"	"Cherubic"
"Untamed"	"Untamed"
"Primordial"	"Primordial"
"Verdant"	"Verdant"
"Burgeoning"	"Burgeoning"
"Adroit"	"Adroit"
"Deft"	"Deft"
"DSNplev"	"Deadly Strike per Level"
"StrSkill300"	"\yellow;0.5% Chance of Crushing Blow per Base Point\grey; "
"Skillname526"	"\orange;Increases Fire Golem Holy Fire Damage by 12% per Level \blue;"
"Skillsd526"	"Placeholder"
"Skillld526"	"Placeholder"
"Skillan526"	"Placeholder"
"Skillname527"	"\orange;1 Additional Skeleton per 5 Level in Raise Skeleton and Raise Skeleton Mage (Sets Golem to 1 Life)\blue;"
"Skillsd527"	"Placeholder"
"Skillld527"	"Placeholder"
"Skillan527"	"Placeholder"
"Skillname528"	"\orange;Gain 1 Additional Bone Spear per Level\blue;"
"Skillsd528"	"Placeholder"
"Skillld528"	"Placeholder"
"Skillan528"	"Placeholder"
"Skillname529"	"\orange;Fire Hawk Fire Damage increased by 15% per Level \blue;"
"Skillsd529"	"Placeholder"
"Skillld529"	"Placeholder"
"Skillan529"	"Placeholder"
"Skillname530"	"\orange;Fire Hawk Crushing Blow Chance increased by 4% per Level \blue;"
"Skillsd530"	"Placeholder"
"Skillld530"	"Placeholder"
"Skillan530"	"Placeholder"
"Skillname531"	"\orange;Raven Lightning Damage increased by 15% per Level \blue;"
"Skillsd531"	"Placeholder"
"Skillld531"	"Placeholder"
"Skillan531"	"Placeholder"
"Skillname532"	"\orange;Raven Crushing Blow Chance increased by 4% per Level \blue;"
"Skillsd532"	"Placeholder"
"Skillld532"	"Placeholder"
"Skillan532"	"Placeholder"
"Skillname533"	"\orange;Twister gains 50% of Cold Skill Damage as extra Physical Damage\blue;"
"Skillsd533"	"Placeholder"
"Skillld533"	"Placeholder"
"Skillan533"	"Placeholder"
"Skillname534"	"\orange;Meteor Shower Frequency is based on Dexterity\blue;"
"Skillsd534"	"Placeholder"
"Skillld534"	"Placeholder"
"Skillan534"	"Placeholder"
"Skillname535"	"\orange;Gain Addtional Holy Bolt Missiles based on Mana\blue;"
"Skillsd535"	"Placeholder"
"Skillld535"	"Placeholder"
"Skillan535"	"Placeholder"
"Skillname536"	"\orange;Increases Holy Aura's Tick Rate by 1 Frame per Level\blue;"
"Skillsd536"	"Placeholder"
"Skillld536"	"Placeholder"
"Skillan536"	"Placeholder"
"Skillname537"	"\orange;Rude Offense Castdelay Reduction is based on Mana\blue;"
"Skillsd537"	"Placeholder"
"Skillld537"	"Placeholder"
"Skillan537"	"Placeholder"
"Skillname538"	"\orange;Barbarian Lightning Skill gain 6% Lightning Skill Damage per Level\blue;"
"Skillsd538"	"Placeholder"
"Skillld538"	"Placeholder"
"Skillan538"	"Placeholder"
"Skillname539"	"\orange;Thunderstorm Frequency increased by 10 Frames per Level\blue;"
"Skillsd539"	"Placeholder"
"Skillld539"	"Placeholder"
"Skillan539"	"Placeholder"
"Skillname540"	"\orange;Frenzy Duration increased by 15 Frames per Level\blue;"
"Skillsd540"	"Placeholder"
"Skillld540"	"Placeholder"
"Skillan540"	"Placeholder"
"Skillname541"	"\orange;Converts additional 6% of Frenzy Physical Damage to Magic Damage per Level\blue;"
"Skillsd541"	"Placeholder"
"Skillld541"	"Placeholder"
"Skillan541"	"Placeholder"
"Skillname542"	"\orange;Molten Boulder Explosion Radius increased by 4 Radius per Level\blue;"
"Skillsd542"	"Placeholder"
"Skillld542"	"Placeholder"
"Skillan542"	"Placeholder"
"Skillname543"	"\orange; Earth Spikes Frequency increased by 1 Frame per Level\n Earth Spikes Radius increased by 1 Radius per Level\blue;"
"Skillsd543"	"Placeholder"
"Skillld543"	"Placeholder"
"Skillan543"	"Placeholder"
"Skillname544"	"\orange;Gain 1 Additional Wolf per Level\blue;"
"Skillsd544"	"Placeholder"
"Skillld544"	"Placeholder"
"Skillan544"	"Placeholder"
"Skillname545"	"\orange;Releases 1 Additional Charged Bolt on Impact with Charged Claws per Level\blue;"
"Skillsd545"	"Placeholder"
"Skillld545"	"Placeholder"
"Skillan545"	"Placeholder"
"Skillname546"	"\orange;Gain Additional Shockwave Missiles based on Mana\blue;"
"Skillsd546"	"Placeholder"
"Skillld546"	"Placeholder"
"Skillan546"	"Placeholder"
"Skillname547"	"\orange;Gain 1 Additional Trap per Level\blue;"
"Skillsd547"	"Placeholder"
"Skillld547"	"Placeholder"
"Skillan547"	"Placeholder"
"Skillname548"	"\orange;Gain Fire and Ice Bolt Missile per 5 Base Points\blue;"
"Skillsd548"	"Placeholder"
"Skillld548"	"Placeholder"
"Skillan548"	"Placeholder"
"Plain"	"Plain"
"Unadorned"	"Unadorned"
"Spartan"	"Spartan"
"Agonizing"	"Agonizing"
"Excruciating"	"Excruciating"
"Harrowing"	"Harrowing"
"Proustite"	"Proustite"
"Sweltering"	"Sweltering"
"Parky"	"Parky"
"of Reinvigorate"	"of Reinvigorate"
"of the Lion"	"of the Lion"
"Sanguine"	"Sanguine"
""	""
""	""
""	""
""	""
""	""
""	""
""	""
""	""
""	""
""	""
""	""
""	""
""	""
""	""
""	""
""	""
